0 1 2 3 4 5 6 7 8 9 10 11 12 13 14 15 16 17 18 19 20 21 22 23 24 25 26 27 28 29 30 31 32 33 34 35 36 37 38 39 40 41 42 43 44 45 46 47 48 49 50 51 
0 1 52 53 54 55 56 57 58 59 60 61 62 63 64 65 66 67 68 69 70 71 72 73 74 75 76 77 78 79 80 81 82 83 84 85 86 87 88 89 90 91 92 93 94 95 96 97 98 99 100 101 
0 1 102 103 104 105 106 107 108 109 110 111 112 113 114 115 116 117 118 119 120 121 122 123 124 125 126 127 128 129 130 131 132 133 134 135 136 137 138 139 140 141 142 143 144 145 146 147 148 149 150 151 
0 1 152 153 154 155 156 157 158 159 160 161 162 163 164 165 166 167 168 169 170 171 172 173 174 175 176 177 178 179 180 181 182 183 184 185 186 187 188 189 190 191 192 193 194 195 196 197 198 199 200 201 
0 1 202 203 204 205 206 207 208 209 210 211 212 213 214 215 216 217 218 219 220 221 222 223 224 225 226 227 228 229 230 231 232 233 234 235 236 237 238 239 240 241 242 243 244 245 246 247 248 249 250 251 
0 1 252 253 254 255 256 257 258 259 260 261 262 263 264 265 266 267 268 269 270 271 272 273 274 275 276 277 278 279 280 281 282 283 284 285 286 287 288 289 290 291 292 293 294 295 296 297 298 299 300 301 
0 1 302 303 304 305 306 307 308 309 310 311 312 313 314 315 316 317 318 319 320 321 322 323 324 325 326 327 328 329 330 331 332 333 334 335 336 337 338 339 340 341 342 343 344 345 346 347 348 349 350 351 
0 1 352 353 354 355 356 357 358 359 360 361 362 363 364 365 366 367 368 369 370 371 372 373 374 375 376 374 377 378 379 380 381 382 383 384 385 364 386 387 388 389 390 391 392 393 394 395 396 397 398 399 
0 1 400 401 402 403 404 405 406 407 408 409 410 411 412 413 414 415 416 417 418 419 420 421 422 423 424 425 426 427 428 418 429 430 431 432 433 434 435 436 437 438 439 440 441 442 443 444 445 446 447 448 
0 1 449 450 451 452 453 454 455 456 457 458 459 460 461 462 462 463 464 465 466 467 468 469 470 471 472 473 474 468 475 476 477 478 479 462 462 480 459 459 481 482 483 484 485 486 487 488 489 490 491 492 
0 1 493 494 495 496 497 498 499 500 501 502 503 503 504 364 364 364 364 505 506 468 507 508 509 510 511 512 513 468 468 514 477 364 364 364 364 515 503 503 516 364 517 518 519 520 521 522 523 524 525 526 
0 1 527 528 529 530 531 532 533 534 535 502 503 503 504 364 364 364 364 536 537 538 539 540 541 542 543 544 545 546 538 547 548 364 364 364 364 515 503 503 516 549 550 551 552 553 554 555 556 557 525 558 
0 1 559 560 561 562 563 564 565 566 567 568 569 569 570 364 364 571 572 573 574 575 576 577 578 579 580 581 582 583 584 585 586 587 363 364 364 588 569 569 589 590 566 591 592 593 594 595 596 597 525 598 
0 1 599 600 601 602 603 604 605 606 606 606 606 607 608 609 609 610 611 611 612 613 614 615 616 616 616 616 617 618 619 620 611 621 622 623 623 624 625 606 606 606 606 626 627 628 629 630 631 597 525 632 
0 1 599 633 634 635 636 637 638 638 638 638 639 640 641 642 643 644 644 644 645 646 647 648 468 468 468 468 649 650 651 652 644 644 644 653 642 654 655 656 638 638 638 638 657 658 659 660 661 597 525 662 
0 1 599 633 663 664 665 637 638 638 638 666 667 668 669 611 670 671 672 672 673 674 675 676 468 468 468 468 677 678 679 680 672 672 681 682 611 683 684 685 656 638 638 638 686 687 688 660 661 597 525 689 
0 1 599 633 690 691 692 637 693 694 695 696 364 668 669 611 697 698 699 700 701 702 703 704 705 706 707 708 709 710 711 712 713 714 715 716 611 683 364 717 718 719 720 721 722 723 724 660 661 597 525 725 
0 1 726 727 728 729 730 731 732 733 611 734 364 668 669 611 697 735 736 737 738 739 740 611 741 364 364 742 611 743 744 745 746 747 748 716 611 683 364 364 749 611 750 751 752 753 754 755 756 757 525 758 
0 1 759 760 761 762 763 764 765 766 767 768 364 769 770 771 772 773 774 775 776 777 778 767 779 364 364 780 767 781 782 783 784 785 786 787 767 788 364 364 789 767 790 791 792 793 794 795 796 797 525 798 
0 1 799 800 801 802 803 804 805 806 807 808 364 364 809 810 811 812 813 814 815 816 817 818 819 364 364 820 821 822 823 824 825 826 827 828 829 830 364 364 831 832 833 834 835 836 837 838 839 840 525 841 
0 1 842 843 844 845 846 847 848 849 850 851 852 853 854 855 856 857 858 859 860 861 862 863 864 865 866 867 868 869 870 871 872 873 874 875 876 877 878 879 880 881 882 883 884 885 886 887 888 889 525 890 
0 1 891 892 893 894 895 896 897 898 899 900 901 902 903 904 905 906 907 908 909 910 911 912 913 914 915 916 917 918 919 920 921 922 923 924 925 926 927 928 929 930 931 932 933 934 935 936 937 938 525 939 
0 1 940 941 942 943 944 945 946 947 109 109 109 109 109 948 949 950 951 952 953 954 955 109 109 109 109 109 109 956 957 958 959 960 961 962 109 109 109 109 109 109 963 964 965 966 967 968 969 970 525 971 
0 1 972 973 974 975 976 977 978 979 980 981 982 983 984 985 986 987 988 989 990 991 992 993 994 995 996 997 998 999 1000 1001 1002 1003 1004 1005 1006 1007 1008 1009 1010 1011 1012 1013 1014 1015 1016 1017 1018 1019 525 1020 
0 1 1021 1022 1023 1024 1025 1026 1027 1028 1029 1030 1031 1032 1033 1034 1035 1036 1037 1038 1039 1040 1041 1042 1043 1044 1045 1046 1047 1048 1049 1050 1051 1052 1053 1054 1055 1056 1057 1058 1059 1060 1061 1062 1063 1064 1065 1066 1067 1068 525 1069 
0 1 1070 1071 1072 1073 1074 1075 1076 1077 1078 1079 1080 1081 1082 1083 1084 1085 1086 1087 1088 1089 1090 1091 1092 1093 1094 1095 1096 1097 1098 1099 1100 1101 1102 1103 1104 1105 1106 1107 1108 1109 1110 1111 1112 1113 1114 1115 1116 1117 525 1118 
0 1 1119 1120 1121 1122 1123 1124 1125 1126 1127 1128 1129 1130 1131 1132 1133 1134 1135 1136 1137 1138 1139 1140 1141 1142 1143 1144 1145 1146 1147 1148 1149 1150 1151 1152 1153 1154 1155 1156 1157 1158 1159 1160 1161 1162 1163 1164 1165 1166 525 1167 
1168 1169 1170 1171 1172 1173 1174 1175 1176 1177 1178 1179 1180 1181 1182 1183 1184 1185 1186 1187 1188 1189 1190 1191 1192 1193 1194 1195 1196 1197 1198 1199 1200 1201 1202 1203 1204 1205 1206 1207 1208 1209 1210 1211 1212 1213 1214 1215 1216 1217 1218 1219 
0 2 4 6 8 10 12 14 16 18 20 22 24 26 28 30 32 34 36 38 40 42 44 46 48 50 
0 102 104 106 108 110 112 114 116 118 120 122 124 126 128 130 132 134 136 138 140 142 144 146 148 150 
0 202 204 206 208 210 212 214 216 218 220 222 224 226 228 230 232 234 236 238 240 242 244 246 248 250 
0 302 304 306 308 310 312 314 316 318 320 322 324 326 328 330 332 334 336 338 340 342 344 346 348 350 
0 400 402 404 406 408 410 412 414 416 418 420 422 424 426 428 429 431 433 435 437 439 441 443 445 447 
0 493 495 497 499 501 503 504 364 364 506 507 509 511 513 468 477 364 364 503 516 517 519 521 523 525 
0 559 561 563 565 567 569 570 364 572 574 576 578 580 582 584 586 363 364 569 589 566 592 594 596 525 
0 599 634 636 638 638 639 641 643 644 645 647 468 468 649 651 644 644 642 655 638 638 657 659 661 525 
0 599 690 692 693 695 364 669 697 699 701 703 705 707 709 711 713 715 611 364 718 720 722 724 661 525 
0 759 761 763 765 767 364 770 772 774 776 778 779 364 767 782 784 786 767 364 789 790 792 794 796 525 
0 842 844 846 848 850 852 854 856 858 860 862 864 866 868 870 872 874 876 878 880 882 884 886 888 525 
0 940 942 944 946 109 109 109 949 951 953 955 109 109 109 957 959 961 109 109 109 963 965 967 969 525 
0 1021 1023 1025 1027 1029 1031 1033 1035 1037 1039 1041 1043 1045 1047 1049 1051 1053 1055 1057 1059 1061 1063 1065 1067 525 
0 1119 1121 1123 1125 1127 1129 1131 1133 1135 1137 1139 1141 1143 1145 1147 1149 1151 1153 1155 1157 1159 1161 1163 1165 525 
0 2 4 6 8 10 12 14 16 18 20 22 24 26 28 30 32 34 36 38 40 42 44 46 48 50 
0 102 104 106 108 110 112 114 116 118 120 122 124 126 128 130 132 134 136 138 140 142 144 146 148 150 
0 202 204 206 208 210 212 214 216 218 220 222 224 226 228 230 232 234 236 238 240 242 244 246 248 250 
0 302 304 306 308 310 312 314 316 318 320 322 324 326 328 330 332 334 336 338 340 342 344 346 348 350 
0 400 402 404 406 408 410 412 414 416 418 420 422 424 426 428 429 431 433 435 437 439 441 443 445 447 
0 493 495 497 499 501 503 504 364 364 506 507 509 511 513 468 477 364 364 503 516 517 519 521 523 525 
0 559 561 563 565 567 569 570 364 572 574 576 578 580 582 584 586 363 364 569 589 566 592 594 596 525 
0 599 634 636 638 638 639 641 643 644 645 647 468 468 649 651 644 644 642 655 638 638 657 659 661 525 
0 599 690 692 693 695 364 669 697 699 701 703 705 707 709 711 713 715 611 364 718 720 722 724 661 525 
0 759 761 763 765 767 364 770 772 774 776 778 779 364 767 782 784 786 767 364 789 790 792 794 796 525 
0 842 844 846 848 850 852 854 856 858 860 862 864 866 868 870 872 874 876 878 880 882 884 886 888 525 
0 940 942 944 946 109 109 109 949 951 953 955 109 109 109 957 959 961 109 109 109 963 965 967 969 525 
0 1021 1023 1025 1027 1029 1031 1033 1035 1037 1039 1041 1043 1045 1047 1049 1051 1053 1055 1057 1059 1061 1063 1065 1067 525 
0 1119 1121 1123 1125 1127 1129 1131 1133 1135 1137 1139 1141 1143 1145 1147 1149 1151 1153 1155 1157 1159 1161 1163 1165 525 
